111111111111111111111
1C00000000000000C0001
100100111111100000001
1001C01110P11C1101101
100100111001101101101
1EC10C1110011011011C1
1111111110011011C1101
111111111001101101101
111111111C000C00C00C1
111111111111111111111